Orthogroup	Enteroscipio	Lactococcus	equolifaciens	isoflavoniconvertens	Total
OG0000000	7	11	12	4	34
OG0000001	32	0	0	0	32
OG0000002	8	1	3	19	31
OG0000003	5	0	23	1	29
OG0000004	9	0	18	1	28
OG0000005	5	0	7	10	22
OG0000006	3	0	10	7	20
OG0000007	0	17	0	0	17
OG0000008	14	0	1	0	15
OG0000009	13	0	2	0	15
OG0000010	2	2	4	7	15
OG0000011	6	0	4	5	15
OG0000012	0	0	1	14	15
OG0000013	14	0	0	0	14
OG0000014	4	4	3	3	14
OG0000015	0	0	10	4	14
OG0000016	11	1	1	0	13
OG0000017	5	6	1	1	13
OG0000018	11	1	1	0	13
OG0000019	5	1	4	3	13
OG0000020	2	1	8	2	13
OG0000021	1	11	0	0	12
OG0000022	11	0	0	1	12
OG0000023	9	1	1	1	12
OG0000024	5	0	3	4	12
OG0000025	3	1	5	3	12
OG0000026	5	1	3	3	12
OG0000027	0	11	1	0	12
OG0000028	3	3	0	5	11
OG0000029	5	2	2	2	11
OG0000030	2	6	2	1	11
OG0000031	0	11	0	0	11
OG0000032	8	0	2	0	10
OG0000033	4	0	3	3	10
OG0000034	10	0	0	0	10
OG0000035	2	2	4	2	10
OG0000036	1	0	7	2	10
OG0000037	5	1	4	0	10
OG0000038	7	0	3	0	10
OG0000039	5	0	2	2	9
OG0000040	2	2	3	2	9
OG0000041	3	3	2	1	9
OG0000042	2	0	4	3	9
OG0000043	2	1	3	3	9
OG0000044	4	0	3	2	9
OG0000045	1	6	1	1	9
OG0000046	0	9	0	0	9
OG0000047	0	0	9	0	9
OG0000048	6	1	0	1	8
OG0000049	5	1	1	1	8
OG0000050	8	0	0	0	8
OG0000051	3	1	2	2	8
OG0000052	8	0	0	0	8
OG0000053	6	0	1	1	8
OG0000054	6	0	1	1	8
OG0000055	1	4	1	2	8
OG0000056	4	0	3	1	8
OG0000057	8	0	0	0	8
OG0000058	3	0	2	3	8
OG0000059	5	0	2	1	8
OG0000060	7	0	1	0	8
OG0000061	3	3	1	1	8
OG0000062	4	0	2	2	8
OG0000063	2	0	2	4	8
OG0000064	4	1	2	1	8
OG0000065	3	1	2	2	8
OG0000066	2	1	3	2	8
OG0000067	1	2	3	2	8
OG0000068	3	0	2	3	8
OG0000069	1	5	1	1	8
OG0000070	2	2	2	2	8
OG0000071	0	0	4	4	8
OG0000072	5	0	1	1	7
OG0000073	2	1	2	2	7
OG0000074	5	0	1	1	7
OG0000075	4	0	3	0	7
OG0000076	2	1	2	2	7
OG0000077	2	4	1	0	7
OG0000078	4	0	2	1	7
OG0000079	5	0	1	1	7
OG0000080	3	1	2	1	7
OG0000081	3	1	1	2	7
OG0000082	2	2	2	1	7
OG0000083	1	2	2	2	7
OG0000084	1	0	5	1	7
OG0000085	1	1	1	4	7
OG0000086	5	0	2	0	7
OG0000087	1	4	1	1	7
OG0000088	2	0	4	1	7
OG0000089	1	0	2	4	7
OG0000090	2	0	3	2	7
OG0000091	1	1	2	3	7
OG0000092	1	2	2	2	7
OG0000093	0	4	2	1	7
OG0000094	0	6	1	0	7
OG0000095	0	6	0	1	7
OG0000096	1	2	2	1	6
OG0000097	2	0	2	2	6
OG0000098	5	0	0	1	6
OG0000099	2	1	1	2	6
OG0000100	1	3	1	1	6
OG0000101	1	1	1	3	6
OG0000102	1	0	2	3	6
OG0000103	4	0	1	1	6
OG0000104	5	0	1	0	6
OG0000105	3	0	3	0	6
OG0000106	2	0	2	2	6
OG0000107	4	0	2	0	6
OG0000108	1	3	1	1	6
OG0000109	1	1	2	2	6
OG0000110	3	0	2	1	6
OG0000111	3	0	2	1	6
OG0000112	2	0	2	2	6
OG0000113	2	2	1	1	6
OG0000114	3	1	2	0	6
OG0000115	2	1	2	1	6
OG0000116	2	0	2	2	6
OG0000117	1	2	2	1	6
OG0000118	2	1	2	1	6
OG0000119	4	0	1	1	6
OG0000120	2	0	3	1	6
OG0000121	2	2	1	1	6
OG0000122	2	1	1	2	6
OG0000123	2	1	2	1	6
OG0000124	3	1	1	1	6
OG0000125	1	0	1	4	6
OG0000126	1	3	1	1	6
OG0000127	2	0	2	2	6
OG0000128	2	1	2	1	6
OG0000129	3	0	1	2	6
OG0000130	2	1	1	2	6
OG0000131	3	0	2	1	6
OG0000132	1	2	1	2	6
OG0000133	1	3	1	1	6
OG0000134	2	1	1	2	6
OG0000135	1	3	1	1	6
OG0000136	2	1	1	2	6
OG0000137	3	1	1	1	6
OG0000138	3	0	2	1	6
OG0000139	1	1	3	1	6
OG0000140	2	2	1	1	6
OG0000141	1	5	0	0	6
OG0000142	2	1	2	1	6
OG0000143	1	0	3	2	6
OG0000144	1	3	1	1	6
OG0000145	1	1	2	2	6
OG0000146	1	1	2	2	6
OG0000147	3	1	2	0	6
OG0000148	1	3	1	1	6
OG0000149	2	0	2	2	6
OG0000150	1	2	2	1	6
OG0000151	1	0	4	1	6
OG0000152	1	3	1	1	6
OG0000153	2	1	0	3	6
OG0000154	1	0	3	2	6
OG0000155	1	1	1	3	6
OG0000156	1	1	2	2	6
OG0000157	1	1	1	3	6
OG0000158	1	1	3	1	6
OG0000159	2	3	1	0	6
OG0000160	1	1	3	1	6
OG0000161	1	1	2	2	6
OG0000162	0	4	1	1	6
OG0000163	0	6	0	0	6
OG0000164	0	4	1	1	6
OG0000165	0	6	0	0	6
OG0000166	1	1	2	1	5
OG0000167	2	1	1	1	5
OG0000168	4	1	0	0	5
OG0000169	5	0	0	0	5
OG0000170	5	0	0	0	5
OG0000171	5	0	0	0	5
OG0000172	5	0	0	0	5
OG0000173	2	2	1	0	5
OG0000174	2	1	1	1	5
OG0000175	3	1	1	0	5
OG0000176	1	3	1	0	5
OG0000177	2	0	2	1	5
OG0000178	1	2	1	1	5
OG0000179	1	1	1	2	5
OG0000180	1	0	3	1	5
OG0000181	4	0	1	0	5
OG0000182	2	1	1	1	5
OG0000183	1	1	2	1	5
OG0000184	2	1	1	1	5
OG0000185	1	1	2	1	5
OG0000186	2	1	1	1	5
OG0000187	3	0	2	0	5
OG0000188	2	1	1	1	5
OG0000189	1	1	2	1	5
OG0000190	2	1	1	1	5
OG0000191	1	2	2	0	5
OG0000192	2	0	0	3	5
OG0000193	2	1	1	1	5
OG0000194	1	1	2	1	5
OG0000195	1	0	3	1	5
OG0000196	2	1	1	1	5
OG0000197	2	0	2	1	5
OG0000198	1	1	1	2	5
OG0000199	4	0	0	1	5
OG0000200	1	2	1	1	5
OG0000201	3	1	1	0	5
OG0000202	4	0	1	0	5
OG0000203	2	1	1	1	5
OG0000204	3	0	1	1	5
OG0000205	3	0	1	1	5
OG0000206	4	0	1	0	5
OG0000207	2	0	2	1	5
OG0000208	1	0	3	1	5
OG0000209	2	1	1	1	5
OG0000210	1	2	1	1	5
OG0000211	3	0	1	1	5
OG0000212	1	2	1	1	5
OG0000213	2	1	1	1	5
OG0000214	1	0	4	0	5
OG0000215	2	0	2	1	5
OG0000216	3	1	1	0	5
OG0000217	4	0	1	0	5
OG0000218	1	1	2	1	5
OG0000219	1	1	3	0	5
OG0000220	5	0	0	0	5
OG0000221	2	0	1	2	5
OG0000222	1	1	2	1	5
OG0000223	1	2	1	1	5
OG0000224	1	1	1	2	5
OG0000225	2	1	1	1	5
OG0000226	2	1	1	1	5
OG0000227	1	2	1	1	5
OG0000228	1	2	1	1	5
OG0000229	1	4	0	0	5
OG0000230	2	1	1	1	5
OG0000231	1	2	2	0	5
OG0000232	1	1	1	2	5
OG0000233	1	2	1	1	5
OG0000234	2	1	1	1	5
OG0000235	1	1	1	2	5
OG0000236	2	1	1	1	5
OG0000237	1	4	0	0	5
OG0000238	2	1	1	1	5
OG0000239	2	0	2	1	5
OG0000240	1	0	2	2	5
OG0000241	1	1	2	1	5
OG0000242	2	1	1	1	5
OG0000243	1	1	1	2	5
OG0000244	1	3	0	1	5
OG0000245	1	1	2	1	5
OG0000246	1	2	1	1	5
OG0000247	1	2	1	1	5
OG0000248	2	1	1	1	5
OG0000249	1	2	1	1	5
OG0000250	1	0	3	1	5
OG0000251	4	0	1	0	5
OG0000252	1	0	2	2	5
OG0000253	1	0	3	1	5
OG0000254	1	2	1	1	5
OG0000255	1	1	2	1	5
OG0000256	1	1	2	1	5
OG0000257	1	2	1	1	5
OG0000258	1	0	3	1	5
OG0000259	2	0	2	1	5
OG0000260	1	2	1	1	5
OG0000261	1	0	2	2	5
OG0000262	2	1	1	1	5
OG0000263	2	0	1	2	5
OG0000264	1	2	1	1	5
OG0000265	1	0	0	4	5
OG0000266	1	2	1	1	5
OG0000267	1	2	1	1	5
OG0000268	2	1	1	1	5
OG0000269	1	0	1	3	5
OG0000270	1	1	2	1	5
OG0000271	1	2	1	1	5
OG0000272	1	2	1	1	5
OG0000273	1	1	2	1	5
OG0000274	2	1	1	1	5
OG0000275	1	2	1	1	5
OG0000276	0	5	0	0	5
OG0000277	0	5	0	0	5
OG0000278	0	5	0	0	5
OG0000279	0	2	1	2	5
OG0000280	0	3	1	1	5
OG0000281	0	0	4	1	5
OG0000282	0	0	3	2	5
OG0000283	1	1	1	1	4
OG0000284	1	1	1	1	4
OG0000285	1	1	1	1	4
OG0000286	1	1	1	1	4
OG0000287	3	0	1	0	4
OG0000288	2	2	0	0	4
OG0000289	4	0	0	0	4
OG0000290	4	0	0	0	4
OG0000291	1	1	1	1	4
OG0000292	1	1	1	1	4
OG0000293	1	1	1	1	4
OG0000294	1	1	1	1	4
OG0000295	1	1	1	1	4
OG0000296	1	1	1	1	4
OG0000297	1	1	1	1	4
OG0000298	1	0	1	2	4
OG0000299	3	0	0	1	4
OG0000300	1	1	1	1	4
OG0000301	1	1	1	1	4
OG0000302	1	0	3	0	4
OG0000303	2	0	1	1	4
OG0000304	1	1	1	1	4
OG0000305	1	1	1	1	4
OG0000306	2	1	0	1	4
OG0000307	4	0	0	0	4
OG0000308	2	0	1	1	4
OG0000309	1	1	1	1	4
OG0000310	1	1	1	1	4
OG0000311	2	0	1	1	4
OG0000312	1	1	1	1	4
OG0000313	4	0	0	0	4
OG0000314	1	1	2	0	4
OG0000315	3	0	0	1	4
OG0000316	1	1	1	1	4
OG0000317	1	1	1	1	4
OG0000318	1	1	1	1	4
OG0000319	1	1	1	1	4
OG0000320	1	1	1	1	4
OG0000321	2	0	1	1	4
OG0000322	2	0	1	1	4
OG0000323	1	1	1	1	4
OG0000324	1	1	1	1	4
OG0000325	1	3	0	0	4
OG0000326	1	1	1	1	4
OG0000327	1	1	1	1	4
OG0000328	2	0	1	1	4
OG0000329	1	1	1	1	4
OG0000330	1	1	1	1	4
OG0000331	1	1	1	1	4
OG0000332	2	0	1	1	4
OG0000333	1	0	2	1	4
OG0000334	1	1	1	1	4
OG0000335	1	1	1	1	4
OG0000336	1	1	1	1	4
OG0000337	2	0	1	1	4
OG0000338	1	1	1	1	4
OG0000339	1	1	1	1	4
OG0000340	2	0	1	1	4
OG0000341	3	0	1	0	4
OG0000342	1	1	1	1	4
OG0000343	2	0	2	0	4
OG0000344	1	1	1	1	4
OG0000345	1	1	1	1	4
OG0000346	1	1	1	1	4
OG0000347	1	1	1	1	4
OG0000348	1	1	1	1	4
OG0000349	1	1	1	1	4
OG0000350	1	1	1	1	4
OG0000351	1	1	1	1	4
OG0000352	1	1	1	1	4
OG0000353	3	0	1	0	4
OG0000354	2	0	1	1	4
OG0000355	1	1	1	1	4
OG0000356	1	1	1	1	4
OG0000357	3	0	1	0	4
OG0000358	1	1	1	1	4
OG0000359	1	1	1	1	4
OG0000360	1	1	1	1	4
OG0000361	1	0	1	2	4
OG0000362	1	1	1	1	4
OG0000363	1	0	1	2	4
OG0000364	1	1	1	1	4
OG0000365	1	1	1	1	4
OG0000366	1	1	1	1	4
OG0000367	1	0	2	1	4
OG0000368	1	1	1	1	4
OG0000369	1	1	1	1	4
OG0000370	1	1	1	1	4
OG0000371	1	1	1	1	4
OG0000372	1	1	1	1	4
OG0000373	1	1	1	1	4
OG0000374	1	1	1	1	4
OG0000375	1	1	1	1	4
OG0000376	2	1	1	0	4
OG0000377	4	0	0	0	4
OG0000378	1	1	1	1	4
OG0000379	1	0	2	1	4
OG0000380	2	0	1	1	4
OG0000381	1	1	1	1	4
OG0000382	1	1	1	1	4
OG0000383	1	1	1	1	4
OG0000384	1	1	1	1	4
OG0000385	1	1	1	1	4
OG0000386	4	0	0	0	4
OG0000387	1	1	1	1	4
OG0000388	1	1	1	1	4
OG0000389	1	0	1	2	4
OG0000390	2	0	1	1	4
OG0000391	2	0	1	1	4
OG0000392	2	0	1	1	4
OG0000393	1	1	1	1	4
OG0000394	1	1	1	1	4
OG0000395	1	1	1	1	4
OG0000396	1	1	1	1	4
OG0000397	1	1	1	1	4
OG0000398	1	0	1	2	4
OG0000399	1	1	1	1	4
OG0000400	1	1	1	1	4
OG0000401	1	0	3	0	4
OG0000402	1	1	1	1	4
OG0000403	1	1	1	1	4
OG0000404	1	1	1	1	4
OG0000405	1	1	1	1	4
OG0000406	2	0	2	0	4
OG0000407	1	1	1	1	4
OG0000408	1	1	1	1	4
OG0000409	3	0	1	0	4
OG0000410	1	1	1	1	4
OG0000411	1	1	1	1	4
OG0000412	1	1	1	1	4
OG0000413	1	1	1	1	4
OG0000414	1	1	1	1	4
OG0000415	1	1	1	1	4
OG0000416	1	1	1	1	4
OG0000417	1	1	1	1	4
OG0000418	2	0	1	1	4
OG0000419	1	0	2	1	4
OG0000420	1	1	1	1	4
OG0000421	1	1	1	1	4
OG0000422	1	1	1	1	4
OG0000423	1	1	1	1	4
OG0000424	1	1	1	1	4
OG0000425	1	1	1	1	4
OG0000426	1	1	1	1	4
OG0000427	1	1	1	1	4
OG0000428	1	1	1	1	4
OG0000429	1	1	1	1	4
OG0000430	1	1	1	1	4
OG0000431	1	1	1	1	4
OG0000432	1	1	1	1	4
OG0000433	1	1	1	1	4
OG0000434	1	1	1	1	4
OG0000435	1	1	1	1	4
OG0000436	1	1	1	1	4
OG0000437	1	0	1	2	4
OG0000438	1	1	1	1	4
OG0000439	1	0	2	1	4
OG0000440	1	1	1	1	4
OG0000441	1	0	2	1	4
OG0000442	1	1	1	1	4
OG0000443	1	0	2	1	4
OG0000444	1	1	1	1	4
OG0000445	1	1	1	1	4
OG0000446	1	1	1	1	4
OG0000447	1	1	1	1	4
OG0000448	1	1	1	1	4
OG0000449	1	1	1	1	4
OG0000450	1	1	1	1	4
OG0000451	1	1	1	1	4
OG0000452	1	1	1	1	4
OG0000453	1	1	1	1	4
OG0000454	1	1	1	1	4
OG0000455	1	1	1	1	4
OG0000456	1	0	2	1	4
OG0000457	1	1	1	1	4
OG0000458	1	1	1	1	4
OG0000459	1	1	1	1	4
OG0000460	1	1	1	1	4
OG0000461	1	1	1	1	4
OG0000462	1	1	1	1	4
OG0000463	1	0	2	1	4
OG0000464	1	0	1	2	4
OG0000465	1	0	1	2	4
OG0000466	1	1	1	1	4
OG0000467	2	0	2	0	4
OG0000468	1	1	1	1	4
OG0000469	1	0	2	1	4
OG0000470	1	0	1	2	4
OG0000471	1	1	1	1	4
OG0000472	1	1	1	1	4
OG0000473	1	1	1	1	4
OG0000474	1	2	1	0	4
OG0000475	1	0	2	1	4
OG0000476	1	1	1	1	4
OG0000477	1	1	1	1	4
OG0000478	1	1	1	1	4
OG0000479	1	1	1	1	4
OG0000480	1	1	1	1	4
OG0000481	1	1	1	1	4
OG0000482	1	1	1	1	4
OG0000483	1	1	1	1	4
OG0000484	1	1	1	1	4
OG0000485	1	1	1	1	4
OG0000486	1	1	1	1	4
OG0000487	1	0	2	1	4
OG0000488	1	1	1	1	4
OG0000489	1	1	1	1	4
OG0000490	1	1	1	1	4
OG0000491	1	1	1	1	4
OG0000492	1	1	1	1	4
OG0000493	1	1	1	1	4
OG0000494	1	1	1	1	4
OG0000495	1	1	1	1	4
OG0000496	2	0	1	1	4
OG0000497	1	1	1	1	4
OG0000498	1	1	1	1	4
OG0000499	1	1	1	1	4
OG0000500	1	1	1	1	4
OG0000501	1	1	1	1	4
OG0000502	1	1	1	1	4
OG0000503	1	1	1	1	4
OG0000504	1	1	1	1	4
OG0000505	1	1	1	1	4
OG0000506	1	1	1	1	4
OG0000507	1	1	1	1	4
OG0000508	1	1	1	1	4
OG0000509	1	1	1	1	4
OG0000510	2	0	1	1	4
OG0000511	1	1	1	1	4
OG0000512	2	0	1	1	4
OG0000513	1	1	1	1	4
OG0000514	1	1	1	1	4
OG0000515	1	1	1	1	4
OG0000516	2	0	1	1	4
OG0000517	1	0	3	0	4
OG0000518	1	2	1	0	4
OG0000519	1	1	1	1	4
OG0000520	1	1	1	1	4
OG0000521	1	1	1	1	4
OG0000522	1	1	1	1	4
OG0000523	1	1	1	1	4
OG0000524	1	1	1	1	4
OG0000525	1	1	1	1	4
OG0000526	1	1	1	1	4
OG0000527	1	1	1	1	4
OG0000528	1	1	1	1	4
OG0000529	1	1	1	1	4
OG0000530	1	1	1	1	4
OG0000531	1	1	1	1	4
OG0000532	1	1	1	1	4
OG0000533	1	1	1	1	4
OG0000534	1	1	1	1	4
OG0000535	1	1	1	1	4
OG0000536	2	0	0	2	4
OG0000537	1	1	1	1	4
OG0000538	1	1	1	1	4
OG0000539	1	1	1	1	4
OG0000540	1	1	1	1	4
OG0000541	1	1	1	1	4
OG0000542	1	1	1	1	4
OG0000543	1	1	1	1	4
OG0000544	1	1	1	1	4
OG0000545	1	1	1	1	4
OG0000546	1	1	1	1	4
OG0000547	1	1	1	1	4
OG0000548	1	1	1	1	4
OG0000549	1	1	1	1	4
OG0000550	1	1	1	1	4
OG0000551	1	1	1	1	4
OG0000552	1	1	1	1	4
OG0000553	1	1	1	1	4
OG0000554	1	1	1	1	4
OG0000555	1	1	1	1	4
OG0000556	1	1	1	1	4
OG0000557	1	1	1	1	4
OG0000558	2	0	1	1	4
OG0000559	2	0	1	1	4
OG0000560	1	0	3	0	4
OG0000561	1	0	2	1	4
OG0000562	1	1	1	1	4
OG0000563	1	1	1	1	4
OG0000564	2	0	2	0	4
OG0000565	3	0	0	1	4
OG0000566	2	0	0	2	4
OG0000567	1	1	1	1	4
OG0000568	1	1	1	1	4
OG0000569	1	1	1	1	4
OG0000570	1	1	1	1	4
OG0000571	1	0	2	1	4
OG0000572	1	0	2	1	4
OG0000573	1	1	1	1	4
OG0000574	1	1	1	1	4
OG0000575	1	1	1	1	4
OG0000576	1	1	1	1	4
OG0000577	1	1	1	1	4
OG0000578	1	1	1	1	4
OG0000579	1	1	1	1	4
OG0000580	1	1	1	1	4
OG0000581	2	1	1	0	4
OG0000582	1	1	1	1	4
OG0000583	1	1	1	1	4
OG0000584	1	1	1	1	4
OG0000585	1	1	1	1	4
OG0000586	1	1	1	1	4
OG0000587	1	1	1	1	4
OG0000588	1	1	1	1	4
OG0000589	1	1	1	1	4
OG0000590	1	1	1	1	4
OG0000591	1	1	1	1	4
OG0000592	1	1	1	1	4
OG0000593	1	1	1	1	4
OG0000594	1	1	1	1	4
OG0000595	1	1	2	0	4
OG0000596	1	1	1	1	4
OG0000597	1	1	1	1	4
OG0000598	1	1	1	1	4
OG0000599	1	1	1	1	4
OG0000600	1	1	1	1	4
OG0000601	1	1	1	1	4
OG0000602	1	1	1	1	4
OG0000603	1	1	1	1	4
OG0000604	1	1	1	1	4
OG0000605	1	1	1	1	4
OG0000606	1	1	1	1	4
OG0000607	1	0	2	1	4
OG0000608	2	0	1	1	4
OG0000609	2	0	1	1	4
OG0000610	1	1	1	1	4
OG0000611	1	1	1	1	4
OG0000612	1	1	1	1	4
OG0000613	1	0	2	1	4
OG0000614	1	1	1	1	4
OG0000615	1	1	1	1	4
OG0000616	1	1	1	1	4
OG0000617	1	1	1	1	4
OG0000618	1	1	1	1	4
OG0000619	1	1	1	1	4
OG0000620	1	1	1	1	4
OG0000621	2	0	1	1	4
OG0000622	1	1	1	1	4
OG0000623	3	0	1	0	4
OG0000624	1	1	1	1	4
OG0000625	1	1	1	1	4
OG0000626	1	1	1	1	4
OG0000627	2	0	1	1	4
OG0000628	1	1	1	1	4
OG0000629	1	1	1	1	4
OG0000630	1	1	1	1	4
OG0000631	1	1	1	1	4
OG0000632	1	1	1	1	4
OG0000633	1	1	1	1	4
OG0000634	1	1	1	1	4
OG0000635	1	1	1	1	4
OG0000636	1	1	1	1	4
OG0000637	1	1	1	1	4
OG0000638	1	1	1	1	4
OG0000639	1	1	1	1	4
OG0000640	1	1	1	1	4
OG0000641	1	1	1	1	4
OG0000642	1	1	1	1	4
OG0000643	1	0	2	1	4
OG0000644	1	1	1	1	4
OG0000645	1	1	1	1	4
OG0000646	1	1	1	1	4
OG0000647	1	1	1	1	4
OG0000648	1	1	1	1	4
OG0000649	1	0	3	0	4
OG0000650	1	1	1	1	4
OG0000651	1	1	1	1	4
OG0000652	1	1	1	1	4
OG0000653	1	1	1	1	4
OG0000654	1	1	1	1	4
OG0000655	1	1	1	1	4
OG0000656	1	1	1	1	4
OG0000657	1	1	1	1	4
OG0000658	1	1	1	1	4
OG0000659	1	1	1	1	4
OG0000660	1	1	1	1	4
OG0000661	1	1	1	1	4
OG0000662	1	1	1	1	4
OG0000663	1	1	1	1	4
OG0000664	1	1	1	1	4
OG0000665	1	1	1	1	4
OG0000666	1	1	1	1	4
OG0000667	1	1	1	1	4
OG0000668	1	1	1	1	4
OG0000669	1	1	1	1	4
OG0000670	1	1	1	1	4
OG0000671	1	1	1	1	4
OG0000672	2	0	1	1	4
OG0000673	1	1	1	1	4
OG0000674	1	1	1	1	4
OG0000675	1	1	1	1	4
OG0000676	1	1	1	1	4
OG0000677	1	1	1	1	4
OG0000678	1	1	1	1	4
OG0000679	1	1	1	1	4
OG0000680	1	1	1	1	4
OG0000681	1	1	0	2	4
OG0000682	1	2	1	0	4
OG0000683	1	1	1	1	4
OG0000684	1	1	1	1	4
OG0000685	3	0	1	0	4
OG0000686	1	1	1	1	4
OG0000687	1	1	1	1	4
OG0000688	1	1	1	1	4
OG0000689	1	1	1	1	4
OG0000690	1	0	1	2	4
OG0000691	4	0	0	0	4
OG0000692	1	1	1	1	4
OG0000693	1	1	1	1	4
OG0000694	1	0	1	2	4
OG0000695	1	1	1	1	4
OG0000696	1	1	1	1	4
OG0000697	1	1	1	1	4
OG0000698	1	1	1	1	4
OG0000699	1	1	1	1	4
OG0000700	1	1	1	1	4
OG0000701	1	1	1	1	4
OG0000702	1	1	1	1	4
OG0000703	1	1	1	1	4
OG0000704	1	1	1	1	4
OG0000705	1	1	1	1	4
OG0000706	1	1	1	1	4
OG0000707	1	1	1	1	4
OG0000708	1	1	1	1	4
OG0000709	1	1	1	1	4
OG0000710	1	1	1	1	4
OG0000711	1	1	1	1	4
OG0000712	1	1	1	1	4
OG0000713	1	1	1	1	4
OG0000714	1	1	1	1	4
OG0000715	1	1	1	1	4
OG0000716	1	1	1	1	4
OG0000717	1	1	1	1	4
OG0000718	1	1	1	1	4
OG0000719	1	1	1	1	4
OG0000720	1	1	1	1	4
OG0000721	1	1	1	1	4
OG0000722	1	3	0	0	4
OG0000723	1	1	1	1	4
OG0000724	3	0	1	0	4
OG0000725	1	1	1	1	4
OG0000726	1	1	1	1	4
OG0000727	2	0	1	1	4
OG0000728	2	0	1	1	4
OG0000729	1	1	1	1	4
OG0000730	1	1	1	1	4
OG0000731	1	1	1	1	4
OG0000732	1	1	1	1	4
OG0000733	1	1	1	1	4
OG0000734	1	1	1	1	4
OG0000735	1	1	1	1	4
OG0000736	1	1	1	1	4
OG0000737	1	1	1	1	4
OG0000738	1	1	1	1	4
OG0000739	1	1	1	1	4
OG0000740	1	1	1	1	4
OG0000741	1	1	1	1	4
OG0000742	1	0	1	2	4
OG0000743	1	1	1	1	4
OG0000744	1	1	1	1	4
OG0000745	1	1	1	1	4
OG0000746	1	1	1	1	4
OG0000747	1	1	1	1	4
OG0000748	1	1	1	1	4
OG0000749	1	1	1	1	4
OG0000750	2	0	1	1	4
OG0000751	1	1	1	1	4
OG0000752	1	1	1	1	4
OG0000753	1	1	1	1	4
OG0000754	1	0	2	1	4
OG0000755	1	0	2	1	4
OG0000756	1	0	2	1	4
OG0000757	1	0	2	1	4
OG0000758	1	1	1	1	4
OG0000759	1	1	1	1	4
OG0000760	1	1	1	1	4
OG0000761	2	1	1	0	4
OG0000762	1	1	1	1	4
OG0000763	1	1	1	1	4
OG0000764	1	1	1	1	4
OG0000765	1	1	1	1	4
OG0000766	1	0	1	2	4
OG0000767	1	1	1	1	4
OG0000768	1	0	3	0	4
OG0000769	1	1	1	1	4
OG0000770	1	1	1	1	4
OG0000771	1	1	1	1	4
OG0000772	1	1	1	1	4
OG0000773	0	4	0	0	4
OG0000774	0	4	0	0	4
OG0000775	0	4	0	0	4
OG0000776	0	3	1	0	4
OG0000777	0	3	1	0	4
OG0000778	0	4	0	0	4
OG0000779	0	2	1	1	4
OG0000780	0	4	0	0	4
OG0000781	0	2	1	1	4
OG0000782	0	2	1	1	4
OG0000783	0	4	0	0	4
OG0000784	0	1	2	1	4
OG0000785	0	4	0	0	4
OG0000786	0	1	2	1	4
OG0000787	0	2	1	1	4
OG0000788	0	1	1	2	4
OG0000789	0	2	2	0	4
OG0000790	0	4	0	0	4
OG0000791	0	0	2	2	4
OG0000792	0	0	4	0	4
OG0000793	0	0	4	0	4
OG0000794	0	0	4	0	4
OG0000795	0	0	2	2	4
OG0000796	0	0	4	0	4
OG0000797	0	0	4	0	4
OG0000798	0	0	2	2	4
OG0000799	0	0	0	4	4
OG0000800	1	0	1	1	3
OG0000801	2	0	0	1	3
OG0000802	1	0	1	1	3
OG0000803	2	0	1	0	3
OG0000804	1	0	1	1	3
OG0000805	1	0	1	1	3
OG0000806	1	0	1	1	3
OG0000807	1	0	1	1	3
OG0000808	3	0	0	0	3
OG0000809	2	0	1	0	3
OG0000810	1	0	1	1	3
OG0000811	1	0	1	1	3
OG0000812	1	0	1	1	3
OG0000813	1	0	1	1	3
OG0000814	1	0	1	1	3
OG0000815	1	0	1	1	3
OG0000816	1	0	2	0	3
OG0000817	1	0	1	1	3
OG0000818	1	0	1	1	3
OG0000819	1	0	1	1	3
OG0000820	1	0	1	1	3
OG0000821	1	0	1	1	3
OG0000822	1	0	1	1	3
OG0000823	1	0	1	1	3
OG0000824	1	1	1	0	3
OG0000825	3	0	0	0	3
OG0000826	3	0	0	0	3
OG0000827	1	2	0	0	3
OG0000828	1	0	1	1	3
OG0000829	1	0	1	1	3
OG0000830	1	0	1	1	3
OG0000831	2	0	1	0	3
OG0000832	1	0	1	1	3
OG0000833	1	1	0	1	3
OG0000834	3	0	0	0	3
OG0000835	1	0	2	0	3
OG0000836	2	0	1	0	3
OG0000837	2	0	1	0	3
OG0000838	2	0	1	0	3
OG0000839	3	0	0	0	3
OG0000840	1	0	1	1	3
OG0000841	1	1	1	0	3
OG0000842	1	0	1	1	3
OG0000843	1	0	1	1	3
OG0000844	1	0	1	1	3
OG0000845	1	0	2	0	3
OG0000846	1	0	1	1	3
OG0000847	1	0	1	1	3
OG0000848	1	0	1	1	3
OG0000849	1	0	1	1	3
OG0000850	1	0	1	1	3
OG0000851	1	0	1	1	3
OG0000852	1	2	0	0	3
OG0000853	1	2	0	0	3
OG0000854	1	0	1	1	3
OG0000855	1	0	1	1	3
OG0000856	1	0	1	1	3
OG0000857	1	0	2	0	3
OG0000858	1	0	1	1	3
OG0000859	1	0	1	1	3
OG0000860	1	0	1	1	3
OG0000861	2	0	1	0	3
OG0000862	2	0	1	0	3
OG0000863	1	1	1	0	3
OG0000864	2	0	1	0	3
OG0000865	1	1	0	1	3
OG0000866	1	0	1	1	3
OG0000867	2	0	1	0	3
OG0000868	3	0	0	0	3
OG0000869	2	0	1	0	3
OG0000870	2	0	1	0	3
OG0000871	2	0	1	0	3
OG0000872	2	1	0	0	3
OG0000873	3	0	0	0	3
OG0000874	1	0	1	1	3
OG0000875	1	0	1	1	3
OG0000876	2	0	0	1	3
OG0000877	2	0	1	0	3
OG0000878	2	0	0	1	3
OG0000879	2	0	1	0	3
OG0000880	1	0	1	1	3
OG0000881	3	0	0	0	3
OG0000882	1	0	1	1	3
OG0000883	1	0	1	1	3
OG0000884	1	0	1	1	3
OG0000885	1	0	1	1	3
OG0000886	1	1	0	1	3
OG0000887	2	0	1	0	3
OG0000888	1	0	1	1	3
OG0000889	1	0	1	1	3
OG0000890	1	0	1	1	3
OG0000891	1	0	1	1	3
OG0000892	1	0	1	1	3
OG0000893	1	0	1	1	3
OG0000894	2	0	1	0	3
OG0000895	1	0	1	1	3
OG0000896	1	0	1	1	3
OG0000897	1	1	1	0	3
OG0000898	3	0	0	0	3
OG0000899	1	0	1	1	3
OG0000900	1	0	1	1	3
OG0000901	1	0	1	1	3
OG0000902	1	0	1	1	3
OG0000903	1	0	1	1	3
OG0000904	1	0	1	1	3
OG0000905	1	0	1	1	3
OG0000906	1	0	1	1	3
OG0000907	1	0	1	1	3
OG0000908	1	0	1	1	3
OG0000909	1	1	1	0	3
OG0000910	1	0	1	1	3
OG0000911	1	0	1	1	3
OG0000912	1	0	1	1	3
OG0000913	1	0	1	1	3
OG0000914	1	0	1	1	3
OG0000915	1	0	1	1	3
OG0000916	1	0	1	1	3
OG0000917	1	0	2	0	3
OG0000918	1	0	1	1	3
OG0000919	1	0	1	1	3
OG0000920	1	0	1	1	3
OG0000921	1	0	1	1	3
OG0000922	1	0	1	1	3
OG0000923	3	0	0	0	3
OG0000924	1	1	0	1	3
OG0000925	1	1	1	0	3
OG0000926	1	1	0	1	3
OG0000927	1	2	0	0	3
OG0000928	1	0	1	1	3
OG0000929	1	0	1	1	3
OG0000930	1	0	1	1	3
OG0000931	1	0	1	1	3
OG0000932	1	0	1	1	3
OG0000933	1	0	1	1	3
OG0000934	1	0	1	1	3
OG0000935	1	0	1	1	3
OG0000936	1	0	1	1	3
OG0000937	1	0	1	1	3
OG0000938	1	0	1	1	3
OG0000939	1	0	1	1	3
OG0000940	1	0	1	1	3
OG0000941	1	0	1	1	3
OG0000942	1	0	1	1	3
OG0000943	1	1	0	1	3
OG0000944	1	0	1	1	3
OG0000945	1	0	1	1	3
OG0000946	1	0	1	1	3
OG0000947	1	0	1	1	3
OG0000948	1	0	1	1	3
OG0000949	1	0	1	1	3
OG0000950	1	0	1	1	3
OG0000951	1	0	1	1	3
OG0000952	1	0	1	1	3
OG0000953	1	0	1	1	3
OG0000954	2	0	1	0	3
OG0000955	1	0	2	0	3
OG0000956	1	0	1	1	3
OG0000957	1	0	1	1	3
OG0000958	1	0	2	0	3
OG0000959	1	0	1	1	3
OG0000960	1	0	1	1	3
OG0000961	1	0	1	1	3
OG0000962	1	1	1	0	3
OG0000963	1	0	1	1	3
OG0000964	1	0	1	1	3
OG0000965	1	0	1	1	3
OG0000966	1	0	1	1	3
OG0000967	1	0	1	1	3
OG0000968	1	0	1	1	3
OG0000969	1	0	1	1	3
OG0000970	1	0	1	1	3
OG0000971	1	0	1	1	3
OG0000972	1	0	1	1	3
OG0000973	1	0	1	1	3
OG0000974	1	0	1	1	3
OG0000975	1	1	0	1	3
OG0000976	1	0	1	1	3
OG0000977	1	0	1	1	3
OG0000978	1	0	1	1	3
OG0000979	1	0	1	1	3
OG0000980	1	0	1	1	3
OG0000981	1	0	1	1	3
OG0000982	1	0	1	1	3
OG0000983	1	0	1	1	3
OG0000984	1	0	1	1	3
OG0000985	1	0	1	1	3
OG0000986	1	0	2	0	3
OG0000987	1	0	1	1	3
OG0000988	1	0	1	1	3
OG0000989	1	0	1	1	3
OG0000990	1	0	1	1	3
OG0000991	1	0	1	1	3
OG0000992	1	0	1	1	3
OG0000993	1	0	1	1	3
OG0000994	1	0	1	1	3
OG0000995	1	0	1	1	3
OG0000996	1	0	1	1	3
OG0000997	1	0	1	1	3
OG0000998	1	0	1	1	3
OG0000999	1	0	1	1	3
OG0001000	1	0	2	0	3
OG0001001	1	0	1	1	3
OG0001002	1	0	1	1	3
OG0001003	1	0	1	1	3
OG0001004	1	0	1	1	3
OG0001005	1	0	1	1	3
OG0001006	1	0	1	1	3
OG0001007	1	0	1	1	3
OG0001008	1	0	1	1	3
OG0001009	1	0	1	1	3
OG0001010	1	0	1	1	3
OG0001011	1	0	1	1	3
OG0001012	1	0	1	1	3
OG0001013	1	0	1	1	3
OG0001014	1	0	1	1	3
OG0001015	1	0	1	1	3
OG0001016	1	0	1	1	3
OG0001017	1	0	1	1	3
OG0001018	1	0	1	1	3
OG0001019	1	0	1	1	3
OG0001020	1	0	1	1	3
OG0001021	1	0	1	1	3
OG0001022	1	0	1	1	3
OG0001023	1	0	1	1	3
OG0001024	1	0	1	1	3
OG0001025	1	0	1	1	3
OG0001026	1	0	1	1	3
OG0001027	1	0	1	1	3
OG0001028	1	0	1	1	3
OG0001029	1	0	1	1	3
OG0001030	1	1	0	1	3
OG0001031	1	0	1	1	3
OG0001032	1	0	1	1	3
OG0001033	1	0	1	1	3
OG0001034	1	1	0	1	3
OG0001035	1	0	2	0	3
OG0001036	1	0	1	1	3
OG0001037	2	0	1	0	3
OG0001038	1	0	2	0	3
OG0001039	1	0	1	1	3
OG0001040	1	0	1	1	3
OG0001041	1	0	1	1	3
OG0001042	1	0	1	1	3
OG0001043	1	1	0	1	3
OG0001044	1	0	1	1	3
OG0001045	1	1	1	0	3
OG0001046	1	0	1	1	3
OG0001047	1	0	1	1	3
OG0001048	1	2	0	0	3
OG0001049	1	1	1	0	3
OG0001050	1	0	1	1	3
OG0001051	1	0	1	1	3
OG0001052	1	0	1	1	3
OG0001053	1	0	1	1	3
OG0001054	1	0	1	1	3
OG0001055	1	0	1	1	3
OG0001056	1	0	1	1	3
OG0001057	1	0	1	1	3
OG0001058	1	0	1	1	3
OG0001059	1	0	1	1	3
OG0001060	1	0	1	1	3
OG0001061	1	0	1	1	3
OG0001062	1	0	1	1	3
OG0001063	1	0	1	1	3
OG0001064	1	0	1	1	3
OG0001065	1	0	1	1	3
OG0001066	1	0	1	1	3
OG0001067	1	0	1	1	3
OG0001068	1	0	1	1	3
OG0001069	1	0	1	1	3
OG0001070	1	0	1	1	3
OG0001071	1	0	1	1	3
OG0001072	1	0	1	1	3
OG0001073	1	0	1	1	3
OG0001074	1	0	1	1	3
OG0001075	1	0	1	1	3
OG0001076	1	0	1	1	3
OG0001077	1	0	1	1	3
OG0001078	1	0	1	1	3
OG0001079	1	0	1	1	3
OG0001080	1	0	1	1	3
OG0001081	1	0	1	1	3
OG0001082	1	0	1	1	3
OG0001083	1	0	1	1	3
OG0001084	1	1	1	0	3
OG0001085	1	0	1	1	3
OG0001086	1	0	1	1	3
OG0001087	1	0	1	1	3
OG0001088	1	0	1	1	3
OG0001089	1	0	1	1	3
OG0001090	1	0	1	1	3
OG0001091	1	0	1	1	3
OG0001092	1	0	1	1	3
OG0001093	1	0	1	1	3
OG0001094	1	0	2	0	3
OG0001095	1	0	2	0	3
OG0001096	1	0	1	1	3
OG0001097	1	0	1	1	3
OG0001098	1	0	1	1	3
OG0001099	1	0	1	1	3
OG0001100	1	0	1	1	3
OG0001101	1	0	1	1	3
OG0001102	1	0	1	1	3
OG0001103	1	0	1	1	3
OG0001104	1	0	1	1	3
OG0001105	1	0	1	1	3
OG0001106	1	0	1	1	3
OG0001107	1	0	1	1	3
OG0001108	1	0	1	1	3
OG0001109	1	0	1	1	3
OG0001110	1	0	1	1	3
OG0001111	1	0	1	1	3
OG0001112	1	0	1	1	3
OG0001113	1	0	2	0	3
OG0001114	1	1	1	0	3
OG0001115	1	1	1	0	3
OG0001116	1	1	1	0	3
OG0001117	1	0	1	1	3
OG0001118	1	0	1	1	3
OG0001119	1	0	1	1	3
OG0001120	1	0	1	1	3
OG0001121	1	0	1	1	3
OG0001122	1	0	1	1	3
OG0001123	1	0	1	1	3
OG0001124	1	0	1	1	3
OG0001125	1	0	1	1	3
OG0001126	1	0	1	1	3
OG0001127	1	0	1	1	3
OG0001128	1	0	1	1	3
OG0001129	1	0	1	1	3
OG0001130	1	0	1	1	3
OG0001131	1	2	0	0	3
OG0001132	1	0	1	1	3
OG0001133	1	0	1	1	3
OG0001134	1	0	1	1	3
OG0001135	1	0	1	1	3
OG0001136	1	0	1	1	3
OG0001137	1	0	1	1	3
OG0001138	1	0	1	1	3
OG0001139	1	0	1	1	3
OG0001140	1	0	1	1	3
OG0001141	1	0	1	1	3
OG0001142	1	0	1	1	3
OG0001143	2	0	1	0	3
OG0001144	1	0	1	1	3
OG0001145	1	0	2	0	3
OG0001146	1	0	1	1	3
OG0001147	1	0	1	1	3
OG0001148	1	0	1	1	3
OG0001149	1	0	1	1	3
OG0001150	1	0	1	1	3
OG0001151	1	0	1	1	3
OG0001152	1	0	1	1	3
OG0001153	1	0	1	1	3
OG0001154	1	0	1	1	3
OG0001155	1	0	1	1	3
OG0001156	1	0	1	1	3
OG0001157	1	0	1	1	3
OG0001158	1	0	1	1	3
OG0001159	1	0	1	1	3
OG0001160	1	0	1	1	3
OG0001161	1	0	1	1	3
OG0001162	1	0	1	1	3
OG0001163	1	0	1	1	3
OG0001164	1	0	1	1	3
OG0001165	1	0	1	1	3
OG0001166	2	0	1	0	3
OG0001167	1	0	1	1	3
OG0001168	1	0	1	1	3
OG0001169	1	0	1	1	3
OG0001170	1	0	1	1	3
OG0001171	1	1	1	0	3
OG0001172	1	0	1	1	3
OG0001173	1	0	1	1	3
OG0001174	1	1	1	0	3
OG0001175	2	0	1	0	3
OG0001176	1	1	1	0	3
OG0001177	1	0	1	1	3
OG0001178	1	0	1	1	3
OG0001179	1	0	1	1	3
OG0001180	1	0	2	0	3
OG0001181	1	0	1	1	3
OG0001182	1	0	1	1	3
OG0001183	1	0	1	1	3
OG0001184	1	0	1	1	3
OG0001185	1	0	1	1	3
OG0001186	1	0	1	1	3
OG0001187	1	0	1	1	3
OG0001188	1	0	1	1	3
OG0001189	1	0	1	1	3
OG0001190	1	0	1	1	3
OG0001191	1	0	1	1	3
OG0001192	1	0	1	1	3
OG0001193	1	0	1	1	3
OG0001194	1	0	2	0	3
OG0001195	1	0	2	0	3
OG0001196	1	0	1	1	3
OG0001197	1	0	1	1	3
OG0001198	1	0	1	1	3
OG0001199	1	0	1	1	3
OG0001200	1	0	1	1	3
OG0001201	1	0	1	1	3
OG0001202	1	1	1	0	3
OG0001203	1	0	1	1	3
OG0001204	1	0	1	1	3
OG0001205	1	0	1	1	3
OG0001206	1	0	1	1	3
OG0001207	1	0	1	1	3
OG0001208	1	0	1	1	3
OG0001209	1	0	1	1	3
OG0001210	1	0	1	1	3
OG0001211	1	0	1	1	3
OG0001212	1	1	1	0	3
OG0001213	1	0	2	0	3
OG0001214	1	0	2	0	3
OG0001215	1	0	1	1	3
OG0001216	1	0	1	1	3
OG0001217	1	0	1	1	3
OG0001218	1	0	1	1	3
OG0001219	1	0	1	1	3
OG0001220	1	0	1	1	3
OG0001221	1	0	1	1	3
OG0001222	1	0	1	1	3
OG0001223	1	0	1	1	3
OG0001224	1	0	1	1	3
OG0001225	1	0	1	1	3
OG0001226	1	0	1	1	3
OG0001227	1	0	1	1	3
OG0001228	1	0	1	1	3
OG0001229	1	1	1	0	3
OG0001230	1	0	1	1	3
OG0001231	1	0	1	1	3
OG0001232	1	0	1	1	3
OG0001233	1	0	1	1	3
OG0001234	1	0	1	1	3
OG0001235	1	0	1	1	3
OG0001236	1	0	1	1	3
OG0001237	1	0	2	0	3
OG0001238	1	0	1	1	3
OG0001239	1	0	1	1	3
OG0001240	1	0	1	1	3
OG0001241	1	0	1	1	3
OG0001242	0	3	0	0	3
OG0001243	0	1	1	1	3
OG0001244	0	3	0	0	3
OG0001245	0	2	1	0	3
OG0001246	0	1	1	1	3
OG0001247	0	3	0	0	3
OG0001248	0	1	1	1	3
OG0001249	0	3	0	0	3
OG0001250	0	2	1	0	3
OG0001251	0	1	1	1	3
OG0001252	0	3	0	0	3
OG0001253	0	1	1	1	3
OG0001254	0	1	1	1	3
OG0001255	0	2	1	0	3
OG0001256	0	2	0	1	3
OG0001257	0	3	0	0	3
OG0001258	0	3	0	0	3
OG0001259	0	3	0	0	3
OG0001260	0	3	0	0	3
OG0001261	0	1	1	1	3
OG0001262	0	1	1	1	3
OG0001263	0	3	0	0	3
OG0001264	0	1	1	1	3
OG0001265	0	1	1	1	3
OG0001266	0	1	1	1	3
OG0001267	0	3	0	0	3
OG0001268	0	1	1	1	3
OG0001269	0	1	1	1	3
OG0001270	0	3	0	0	3
OG0001271	0	1	1	1	3
OG0001272	0	1	1	1	3
OG0001273	0	1	1	1	3
OG0001274	0	1	1	1	3
OG0001275	0	1	1	1	3
OG0001276	0	1	1	1	3
OG0001277	0	1	1	1	3
OG0001278	0	1	1	1	3
OG0001279	0	1	1	1	3
OG0001280	0	1	1	1	3
OG0001281	0	1	1	1	3
OG0001282	0	3	0	0	3
OG0001283	0	1	2	0	3
OG0001284	0	1	1	1	3
OG0001285	0	1	1	1	3
OG0001286	0	1	1	1	3
OG0001287	0	1	1	1	3
OG0001288	0	1	1	1	3
OG0001289	0	1	1	1	3
OG0001290	0	1	1	1	3
OG0001291	0	1	1	1	3
OG0001292	0	1	1	1	3
OG0001293	0	1	1	1	3
OG0001294	0	1	1	1	3
OG0001295	0	1	1	1	3
OG0001296	0	0	1	2	3
OG0001297	0	0	2	1	3
OG0001298	0	0	1	2	3
OG0001299	0	0	3	0	3
OG0001300	0	0	2	1	3
OG0001301	0	0	2	1	3
OG0001302	0	0	2	1	3
OG0001303	0	0	2	1	3
OG0001304	0	0	3	0	3
OG0001305	0	0	1	2	3
OG0001306	0	0	2	1	3
OG0001307	0	0	2	1	3
OG0001308	0	0	1	2	3
OG0001309	0	0	1	2	3
OG0001310	0	0	1	2	3
OG0001311	0	0	0	3	3
OG0001312	1	1	0	0	2
OG0001313	2	0	0	0	2
OG0001314	2	0	0	0	2
OG0001315	2	0	0	0	2
OG0001316	2	0	0	0	2
OG0001317	2	0	0	0	2
OG0001318	2	0	0	0	2
OG0001319	2	0	0	0	2
OG0001320	2	0	0	0	2
OG0001321	2	0	0	0	2
OG0001322	2	0	0	0	2
OG0001323	2	0	0	0	2
OG0001324	2	0	0	0	2
OG0001325	2	0	0	0	2
OG0001326	2	0	0	0	2
OG0001327	2	0	0	0	2
OG0001328	1	0	0	1	2
OG0001329	2	0	0	0	2
OG0001330	2	0	0	0	2
OG0001331	1	0	0	1	2
OG0001332	1	0	1	0	2
OG0001333	2	0	0	0	2
OG0001334	1	1	0	0	2
OG0001335	1	1	0	0	2
OG0001336	1	0	1	0	2
OG0001337	1	0	1	0	2
OG0001338	1	0	0	1	2
OG0001339	1	0	0	1	2
OG0001340	1	0	0	1	2
OG0001341	2	0	0	0	2
OG0001342	1	1	0	0	2
OG0001343	1	0	1	0	2
OG0001344	1	0	0	1	2
OG0001345	2	0	0	0	2
OG0001346	2	0	0	0	2
OG0001347	1	0	0	1	2
OG0001348	1	0	0	1	2
OG0001349	1	0	0	1	2
OG0001350	1	0	0	1	2
OG0001351	1	0	1	0	2
OG0001352	2	0	0	0	2
OG0001353	1	0	0	1	2
OG0001354	1	0	1	0	2
OG0001355	1	0	1	0	2
OG0001356	1	1	0	0	2
OG0001357	2	0	0	0	2
OG0001358	2	0	0	0	2
OG0001359	2	0	0	0	2
OG0001360	1	0	1	0	2
OG0001361	1	0	1	0	2
OG0001362	1	0	1	0	2
OG0001363	1	1	0	0	2
OG0001364	1	1	0	0	2
OG0001365	1	0	1	0	2
OG0001366	2	0	0	0	2
OG0001367	2	0	0	0	2
OG0001368	1	0	0	1	2
OG0001369	1	0	1	0	2
OG0001370	1	0	1	0	2
OG0001371	1	0	1	0	2
OG0001372	1	0	0	1	2
OG0001373	1	0	1	0	2
OG0001374	1	0	1	0	2
OG0001375	1	0	1	0	2
OG0001376	1	0	0	1	2
OG0001377	2	0	0	0	2
OG0001378	2	0	0	0	2
OG0001379	2	0	0	0	2
OG0001380	2	0	0	0	2
OG0001381	2	0	0	0	2
OG0001382	2	0	0	0	2
OG0001383	2	0	0	0	2
OG0001384	2	0	0	0	2
OG0001385	2	0	0	0	2
OG0001386	2	0	0	0	2
OG0001387	2	0	0	0	2
OG0001388	2	0	0	0	2
OG0001389	2	0	0	0	2
OG0001390	2	0	0	0	2
OG0001391	1	0	1	0	2
OG0001392	1	0	0	1	2
OG0001393	1	0	1	0	2
OG0001394	1	0	1	0	2
OG0001395	2	0	0	0	2
OG0001396	1	0	1	0	2
OG0001397	1	0	1	0	2
OG0001398	1	1	0	0	2
OG0001399	1	1	0	0	2
OG0001400	2	0	0	0	2
OG0001401	1	0	1	0	2
OG0001402	1	0	1	0	2
OG0001403	1	0	0	1	2
OG0001404	2	0	0	0	2
OG0001405	2	0	0	0	2
OG0001406	2	0	0	0	2
OG0001407	1	0	0	1	2
OG0001408	1	0	1	0	2
OG0001409	1	0	1	0	2
OG0001410	1	0	1	0	2
OG0001411	1	0	1	0	2
OG0001412	1	0	1	0	2
OG0001413	2	0	0	0	2
OG0001414	2	0	0	0	2
OG0001415	2	0	0	0	2
OG0001416	1	0	1	0	2
OG0001417	1	0	1	0	2
OG0001418	1	0	1	0	2
OG0001419	1	0	1	0	2
OG0001420	1	0	1	0	2
OG0001421	1	0	1	0	2
OG0001422	1	0	0	1	2
OG0001423	1	0	1	0	2
OG0001424	1	1	0	0	2
OG0001425	1	0	1	0	2
OG0001426	1	0	1	0	2
OG0001427	1	0	1	0	2
OG0001428	2	0	0	0	2
OG0001429	2	0	0	0	2
OG0001430	1	0	1	0	2
OG0001431	1	0	1	0	2
OG0001432	1	0	1	0	2
OG0001433	2	0	0	0	2
OG0001434	2	0	0	0	2
OG0001435	1	0	0	1	2
OG0001436	1	1	0	0	2
OG0001437	1	0	0	1	2
OG0001438	1	0	0	1	2
OG0001439	1	0	1	0	2
OG0001440	2	0	0	0	2
OG0001441	1	0	1	0	2
OG0001442	1	1	0	0	2
OG0001443	1	0	1	0	2
OG0001444	1	0	1	0	2
OG0001445	1	0	0	1	2
OG0001446	1	0	0	1	2
OG0001447	1	0	1	0	2
OG0001448	2	0	0	0	2
OG0001449	1	0	1	0	2
OG0001450	1	0	1	0	2
OG0001451	1	0	1	0	2
OG0001452	1	1	0	0	2
OG0001453	1	0	1	0	2
OG0001454	1	0	1	0	2
OG0001455	1	0	1	0	2
OG0001456	1	0	0	1	2
OG0001457	1	0	0	1	2
OG0001458	1	0	1	0	2
OG0001459	1	0	1	0	2
OG0001460	1	0	1	0	2
OG0001461	1	1	0	0	2
OG0001462	1	0	0	1	2
OG0001463	1	0	0	1	2
OG0001464	1	0	0	1	2
OG0001465	1	0	0	1	2
OG0001466	1	0	1	0	2
OG0001467	2	0	0	0	2
OG0001468	1	1	0	0	2
OG0001469	1	1	0	0	2
OG0001470	2	0	0	0	2
OG0001471	2	0	0	0	2
OG0001472	1	0	0	1	2
OG0001473	1	0	0	1	2
OG0001474	1	0	0	1	2
OG0001475	1	0	0	1	2
OG0001476	1	0	0	1	2
OG0001477	1	1	0	0	2
OG0001478	1	0	1	0	2
OG0001479	2	0	0	0	2
OG0001480	1	0	1	0	2
OG0001481	1	0	1	0	2
OG0001482	1	0	1	0	2
OG0001483	1	0	1	0	2
OG0001484	1	0	1	0	2
OG0001485	1	0	1	0	2
OG0001486	1	0	1	0	2
OG0001487	1	0	1	0	2
OG0001488	1	0	1	0	2
OG0001489	1	0	1	0	2
OG0001490	1	0	1	0	2
OG0001491	1	0	1	0	2
OG0001492	1	0	1	0	2
OG0001493	1	0	1	0	2
OG0001494	1	0	1	0	2
OG0001495	2	0	0	0	2
OG0001496	1	1	0	0	2
OG0001497	1	1	0	0	2
OG0001498	1	0	0	1	2
OG0001499	1	0	0	1	2
OG0001500	1	0	1	0	2
OG0001501	1	1	0	0	2
OG0001502	1	1	0	0	2
OG0001503	2	0	0	0	2
OG0001504	1	1	0	0	2
OG0001505	1	1	0	0	2
OG0001506	1	1	0	0	2
OG0001507	1	0	0	1	2
OG0001508	1	0	0	1	2
OG0001509	1	0	1	0	2
OG0001510	1	0	1	0	2
OG0001511	1	0	0	1	2
OG0001512	1	1	0	0	2
OG0001513	1	1	0	0	2
OG0001514	1	0	0	1	2
OG0001515	1	0	0	1	2
OG0001516	1	1	0	0	2
OG0001517	1	1	0	0	2
OG0001518	1	0	1	0	2
OG0001519	1	0	1	0	2
OG0001520	1	0	1	0	2
OG0001521	1	0	1	0	2
OG0001522	1	0	1	0	2
OG0001523	1	0	0	1	2
OG0001524	1	0	0	1	2
OG0001525	1	0	1	0	2
OG0001526	1	0	1	0	2
OG0001527	2	0	0	0	2
OG0001528	1	0	0	1	2
OG0001529	1	0	1	0	2
OG0001530	1	0	1	0	2
OG0001531	1	0	1	0	2
OG0001532	2	0	0	0	2
OG0001533	1	0	1	0	2
OG0001534	1	0	1	0	2
OG0001535	1	1	0	0	2
OG0001536	1	1	0	0	2
OG0001537	1	0	0	1	2
OG0001538	1	0	1	0	2
OG0001539	1	0	1	0	2
OG0001540	1	0	1	0	2
OG0001541	1	0	1	0	2
OG0001542	1	0	1	0	2
OG0001543	1	0	0	1	2
OG0001544	1	0	0	1	2
OG0001545	1	0	0	1	2
OG0001546	1	0	1	0	2
OG0001547	1	0	1	0	2
OG0001548	1	1	0	0	2
OG0001549	1	0	1	0	2
OG0001550	1	0	1	0	2
OG0001551	1	0	1	0	2
OG0001552	1	0	1	0	2
OG0001553	2	0	0	0	2
OG0001554	1	0	0	1	2
OG0001555	1	1	0	0	2
OG0001556	1	0	0	1	2
OG0001557	1	0	1	0	2
OG0001558	1	1	0	0	2
OG0001559	1	0	1	0	2
OG0001560	1	0	1	0	2
OG0001561	1	0	1	0	2
OG0001562	1	0	1	0	2
OG0001563	1	0	1	0	2
OG0001564	1	0	1	0	2
OG0001565	1	0	1	0	2
OG0001566	1	0	1	0	2
OG0001567	1	0	0	1	2
OG0001568	1	1	0	0	2
OG0001569	1	1	0	0	2
OG0001570	1	1	0	0	2
OG0001571	1	1	0	0	2
OG0001572	1	1	0	0	2
OG0001573	1	1	0	0	2
OG0001574	1	1	0	0	2
OG0001575	1	0	1	0	2
OG0001576	1	0	1	0	2
OG0001577	1	0	1	0	2
OG0001578	1	0	1	0	2
OG0001579	1	0	0	1	2
OG0001580	1	0	0	1	2
OG0001581	1	1	0	0	2
OG0001582	1	0	1	0	2
OG0001583	1	0	1	0	2
OG0001584	1	0	0	1	2
OG0001585	0	2	0	0	2
OG0001586	0	2	0	0	2
OG0001587	0	2	0	0	2
OG0001588	0	2	0	0	2
OG0001589	0	2	0	0	2
OG0001590	0	2	0	0	2
OG0001591	0	2	0	0	2
OG0001592	0	1	0	1	2
OG0001593	0	2	0	0	2
OG0001594	0	2	0	0	2
OG0001595	0	1	1	0	2
OG0001596	0	1	1	0	2
OG0001597	0	2	0	0	2
OG0001598	0	2	0	0	2
OG0001599	0	2	0	0	2
OG0001600	0	2	0	0	2
OG0001601	0	2	0	0	2
OG0001602	0	2	0	0	2
OG0001603	0	2	0	0	2
OG0001604	0	2	0	0	2
OG0001605	0	2	0	0	2
OG0001606	0	2	0	0	2
OG0001607	0	1	1	0	2
OG0001608	0	2	0	0	2
OG0001609	0	2	0	0	2
OG0001610	0	1	0	1	2
OG0001611	0	2	0	0	2
OG0001612	0	2	0	0	2
OG0001613	0	1	1	0	2
OG0001614	0	1	1	0	2
OG0001615	0	1	1	0	2
OG0001616	0	2	0	0	2
OG0001617	0	2	0	0	2
OG0001618	0	1	1	0	2
OG0001619	0	2	0	0	2
OG0001620	0	2	0	0	2
OG0001621	0	2	0	0	2
OG0001622	0	1	1	0	2
OG0001623	0	1	1	0	2
OG0001624	0	2	0	0	2
OG0001625	0	2	0	0	2
OG0001626	0	2	0	0	2
OG0001627	0	2	0	0	2
OG0001628	0	2	0	0	2
OG0001629	0	2	0	0	2
OG0001630	0	2	0	0	2
OG0001631	0	2	0	0	2
OG0001632	0	2	0	0	2
OG0001633	0	2	0	0	2
OG0001634	0	1	0	1	2
OG0001635	0	1	1	0	2
OG0001636	0	1	1	0	2
OG0001637	0	1	0	1	2
OG0001638	0	2	0	0	2
OG0001639	0	1	1	0	2
OG0001640	0	2	0	0	2
OG0001641	0	2	0	0	2
OG0001642	0	2	0	0	2
OG0001643	0	2	0	0	2
OG0001644	0	1	0	1	2
OG0001645	0	2	0	0	2
OG0001646	0	2	0	0	2
OG0001647	0	1	0	1	2
OG0001648	0	2	0	0	2
OG0001649	0	1	1	0	2
OG0001650	0	2	0	0	2
OG0001651	0	2	0	0	2
OG0001652	0	1	0	1	2
OG0001653	0	2	0	0	2
OG0001654	0	2	0	0	2
OG0001655	0	1	1	0	2
OG0001656	0	2	0	0	2
OG0001657	0	1	0	1	2
OG0001658	0	2	0	0	2
OG0001659	0	2	0	0	2
OG0001660	0	1	0	1	2
OG0001661	0	2	0	0	2
OG0001662	0	2	0	0	2
OG0001663	0	1	1	0	2
OG0001664	0	2	0	0	2
OG0001665	0	2	0	0	2
OG0001666	0	2	0	0	2
OG0001667	0	1	0	1	2
OG0001668	0	2	0	0	2
OG0001669	0	2	0	0	2
OG0001670	0	2	0	0	2
OG0001671	0	1	1	0	2
OG0001672	0	2	0	0	2
OG0001673	0	2	0	0	2
OG0001674	0	2	0	0	2
OG0001675	0	1	0	1	2
OG0001676	0	1	1	0	2
OG0001677	0	1	1	0	2
OG0001678	0	2	0	0	2
OG0001679	0	1	1	0	2
OG0001680	0	0	2	0	2
OG0001681	0	0	2	0	2
OG0001682	0	0	2	0	2
OG0001683	0	0	1	1	2
OG0001684	0	0	1	1	2
OG0001685	0	0	2	0	2
OG0001686	0	0	1	1	2
OG0001687	0	0	1	1	2
OG0001688	0	0	1	1	2
OG0001689	0	0	1	1	2
OG0001690	0	0	1	1	2
OG0001691	0	0	1	1	2
OG0001692	0	0	1	1	2
OG0001693	0	0	1	1	2
OG0001694	0	0	1	1	2
OG0001695	0	0	1	1	2
OG0001696	0	0	2	0	2
OG0001697	0	0	1	1	2
OG0001698	0	0	2	0	2
OG0001699	0	0	1	1	2
OG0001700	0	0	2	0	2
OG0001701	0	0	1	1	2
OG0001702	0	0	1	1	2
OG0001703	0	0	1	1	2
OG0001704	0	0	1	1	2
OG0001705	0	0	1	1	2
OG0001706	0	0	1	1	2
OG0001707	0	0	1	1	2
OG0001708	0	0	1	1	2
OG0001709	0	0	2	0	2
OG0001710	0	0	2	0	2
OG0001711	0	0	1	1	2
OG0001712	0	0	1	1	2
OG0001713	0	0	1	1	2
OG0001714	0	0	1	1	2
OG0001715	0	0	1	1	2
OG0001716	0	0	1	1	2
OG0001717	0	0	2	0	2
OG0001718	0	0	1	1	2
OG0001719	0	0	1	1	2
OG0001720	0	0	2	0	2
OG0001721	0	0	2	0	2
OG0001722	0	0	1	1	2
OG0001723	0	0	2	0	2
OG0001724	0	0	1	1	2
OG0001725	0	0	1	1	2
OG0001726	0	0	1	1	2
OG0001727	0	0	1	1	2
OG0001728	0	0	1	1	2
OG0001729	0	0	1	1	2
OG0001730	0	0	1	1	2
OG0001731	0	0	1	1	2
OG0001732	0	0	1	1	2
OG0001733	0	0	1	1	2
OG0001734	0	0	1	1	2
OG0001735	0	0	1	1	2
OG0001736	0	0	1	1	2
OG0001737	0	0	1	1	2
OG0001738	0	0	1	1	2
OG0001739	0	0	1	1	2
OG0001740	0	0	1	1	2
OG0001741	0	0	1	1	2
OG0001742	0	0	1	1	2
OG0001743	0	0	1	1	2
OG0001744	0	0	1	1	2
OG0001745	0	0	1	1	2
OG0001746	0	0	1	1	2
OG0001747	0	0	1	1	2
OG0001748	0	0	1	1	2
OG0001749	0	0	2	0	2
OG0001750	0	0	1	1	2
OG0001751	0	0	2	0	2
OG0001752	0	0	2	0	2
OG0001753	0	0	1	1	2
OG0001754	0	0	1	1	2
OG0001755	0	0	1	1	2
OG0001756	0	0	1	1	2
OG0001757	0	0	1	1	2
OG0001758	0	0	1	1	2
OG0001759	0	0	2	0	2
OG0001760	0	0	1	1	2
OG0001761	0	0	1	1	2
OG0001762	0	0	2	0	2
OG0001763	0	0	1	1	2
OG0001764	0	0	1	1	2
OG0001765	0	0	1	1	2
OG0001766	0	0	1	1	2
OG0001767	0	0	1	1	2
OG0001768	0	0	1	1	2
OG0001769	0	0	1	1	2
OG0001770	0	0	1	1	2
OG0001771	0	0	1	1	2
OG0001772	0	0	1	1	2
OG0001773	0	0	1	1	2
OG0001774	0	0	1	1	2
OG0001775	0	0	1	1	2
OG0001776	0	0	1	1	2
OG0001777	0	0	1	1	2
OG0001778	0	0	1	1	2
OG0001779	0	0	1	1	2
OG0001780	0	0	1	1	2
OG0001781	0	0	1	1	2
OG0001782	0	0	1	1	2
OG0001783	0	0	1	1	2
OG0001784	0	0	1	1	2
OG0001785	0	0	1	1	2
OG0001786	0	0	1	1	2
OG0001787	0	0	1	1	2
OG0001788	0	0	1	1	2
OG0001789	0	0	1	1	2
OG0001790	0	0	1	1	2
OG0001791	0	0	1	1	2
OG0001792	0	0	1	1	2
OG0001793	0	0	1	1	2
OG0001794	0	0	2	0	2
OG0001795	0	0	1	1	2
OG0001796	0	0	1	1	2
OG0001797	0	0	1	1	2
OG0001798	0	0	1	1	2
OG0001799	0	0	1	1	2
OG0001800	0	0	1	1	2
OG0001801	0	0	1	1	2
OG0001802	0	0	1	1	2
OG0001803	0	0	1	1	2
OG0001804	0	0	1	1	2
OG0001805	0	0	0	2	2
OG0001806	0	0	0	2	2
OG0001807	0	0	0	2	2
OG0001808	0	0	0	2	2
OG0001809	0	0	0	2	2
OG0001810	0	0	0	2	2
OG0001811	0	0	0	2	2
OG0001812	0	0	0	2	2
